#####################
#P....S......^......#
#.....^^^^....^..H..#
#..........^..^.....#
#..~~~~~~..^..^..M..#
#..~.M.....^........#
#..~.......^^^^^^...#
#..~~~~~~...........#
#....M.........D....#
#####################
