############
#P.S^^^^^^^#
#...D..~~~~#
#H..M..M..M#
############